M____H_M_W_M
MSS_S_SSSS_M
MB__SBS__S_M
MM__SBS__S_M
M<__SSS_KS_M
M___MMM__S_M
MTBTSSB__S_M
MTTT__+-_B_M
M_MMM_H__B_M
BSSSSBBSSSBM
MV_____M___M
MMM<MMM>MSMM
