_VM_SBS__BB___M
_M_MSSS_KSSH__+
____MM___S_SSMS
_TBT_____SM_MB_
_TTT__+-_B___B_
__MMMM___S_-nB_
_TBT__M__S___M_